EXAMINATION=This is the fear of a student
GOVERNMENT=An illusion on which people put faith
TEACHER=One person students hate
COLLECTOR=Don't know what the job is but every one wants it
SPONGE=What is full of holes but still holds water?
FUTURE=What is always in front of you but can’t be seen?
PROMISE=What can you break, even if you never pick it up or touch it?
DARKNESS=The more there is, the less you see. What am I?
CRANE=What bird do you associate with lifting weight?
LIGHT=What can go through glass without breaking it?
PIANO=I'm full of keys but can't open any locks. What am I?
STAMP=What can travel around the world while staying in a corner?
FOOTSTEPS=The more you take, the more you leave behind. What am I?
CANDLE=I'm tall when I'm young, and I'm short when I'm old. What am I?
TOMORROW=What is always coming but never arrives?
LEFTHAND=What can you hold in your right hand but never in your left?
THOUGHT=I am weightless, but I can crush you. What am I?
DESIRE=I am always hungry and thirsty.The more you give me, the bigger I grow. What am I?
POSTOFFICE=What has only two words, but thousands of letters?
NOTHING=People in poverty have this. If you eat this you will die. What is it?
YOURSELF=I am the reason you exist, but you can never find me?
HOLE=A can of water weighs 60 litres. What must you put in it for it to weigh 40 iltres?
BROOM=What has golden hair and stands in the corner?
SWIMS=What word looks the same upside down and backward?
REFLECTION=You can see me in water, but I never get wet. What am I?
YOURNAME=This belongs to you, but everyone else uses it.
EMOTION=Stronger than iron, crueler than death, sweeter than springtime it lives beyond breath.
PILLOW=What loses its head in the morning and gets it back at night?
CHOICE=What is it that given one, you’ll have either two or none?
CARDS=What has fifteen diamonds but isn’t rich?
CIRCLE=What has no beginning, middle or end?

